Jane Weaver - I Need A Connection
Broadcast - Come On Let's Go
Vanishing Twin - The Conservation Of Energy (Official Video)
Emiliana Torrini - Unemployed In Summertime
Ehla - Pas d'ici (Clip Officiel)
Ora The Molecule - Creator (Official Video)
Regrets - Je ne veux pas rentrer chez moi seule - 1983
Amii Stewart - Knock On Wood (Official Video)
nipplepeople FRKA (Official video), Kire Mitrev, Slavica Maras
Viola Valentino - Romantici (1982)
Jenny Hval - Spells (Official Music Video)
Odd Beholder - Disaster Movies
Marnie - The Hunter (Official Video)
iamamiwhoami; o
RIVE - Vogue
Clara Luciani - Monstre d'Amour (Clip Officiel)
Buscabulla - Caer
piri & tommy villiers - soft spot (official music video)
戸川純－好き好き大好き
Grimes - Oblivion
JOON "E.T." (Official Video)
Boys in Lilies - BOY (OFFICIAL VIDEO)
AURORA - Running With The Wolves
Princess Chelsea - The Loneliest Girl
Bonnie Banane - La Lune & Le Soleil (Official Video)
Barbara Wrońska - Nie czekaj (Official Video)
La Féline - Où est passée ton âme ?
Julia Holter - Everytime Boots
Hako Yamasaki - Help Me (Tsunawatari)
Cléa Vincent - Jmy attendais pas
Cléa Vincent - Retiens mon désir
Amadou & Mariam - Sabali (Official Music Video)
Fever Ray  When I Grow Up D Lissvik Remix
Agar Agar - Fangs Out (Clip officiel)
Oh Land - Human
Bent - Private Road
Agar Agar - Cuidado, Peligro, Eclipse
Véronique Sanson-Amoureuse
Corine - My Lady Heroine
Buttering Trio - I Cried For You (Official Video)
Eileen - Ces bottes sont faites pour marcher
Nalyssa Green - Κοκτέιλ
Marie Laforêt - Saint-Tropez Blues (Remastered)
王菲 - 你快樂 所以我快樂
王菲 -《夢中人 》剪輯版MV (1080p)
France Gall - Comment lui dire (1976)
Cléa Vincent - Château Perdu
Fern Kinney - Love Me Tonight (Love, Love, Love)
Dee D Jackson - Meteor Man (1978/TV show/HD)
Amanda Lear - Enigma (Give a Bit of Mmh to Me)
Madonna - Vogue (Live at the MTV Awards 1990) [Official Video]
Elli et Jacno - Main dans la main
Niagara - Pendant que les champs brûlent (Clip Officiel Remasterisé)
Morcheeba - Blindfold - Big Calm (1998)
Niagara - La fin des étoiles (Clip Officiel Remasterisé)
Bjork- Big Time Sensuality
The Cranberries - Linger (Official Music Video)
Lisa Hannigan | What'll I Do [Official Video]
Dark Dark Dark "In Your Dreams" on WNYC's Spinning On Air
Alizée - J'en ai marre ! (Clip Officiel HD)
Mylène Farmer - Désenchantée - HD
Eurythmics, Annie Lennox, Dave Stewart - Here Comes The Rain Again (Remastered)
Izem - Agua Viva
Simian Mobile Disco - Hey Sister
Bulgarian Symphony Orchestra - Initials BB
MonteRosso - Huacachina | Parisien 4
Kate Bush - Army Dreamers - Official Music Video
Giorgio Moroder - From Here To Eternity
Blondie - Heart Of Glass
Keren Ann - My name is trouble [Official Music Video]
Chrystabell - Heaven (Official Video)
Jain - So Peaceful (Audio)
Austra - Lose It (Official Video)
Heart - "Barracuda" (1977)
Kovacs - My Love (Official Video)
Lynsey De Paul ~ Sugar Me. Nr.1 Hit 1972. HD ( ↓ Lyrics ↓ )
POLIÇA - "Lime Habit" (Official Music Video)
Alexia Gredy - Mon rêveur
Le Couleur - Femme
The Dø - Trustful Hands (Live at l’Olympia, Paris)
Lamb - We Fall in Love (audio - single version)
Mylène Farmer - The Farmer Project (Clip Officiel)
J Dilla - hydrant game(instrumental)
VITALIC - Poison Lips (Official)
Vive la Fête - Noir Désir
Future Soundscapes - Roxanne
Blue Man Group w/ Venus Hum: I Feel Love (best quality)
Freedom Satellite · Sun Ra · Sun Ra · Freedom Satellite · Freedom Satellite · Freedom Satellite - Astro Black (The Big Wow Mix)
Anna B Savage - in|FLUX (Official Video)
2013 Meditaçao  ANDREA MOTIS JOAN CHAMORRO QUINTET & SCOTT HAMILTON
Kelly Lee Owens - Night
Corine - Maquillage
Pizzicato Five - Porno 3003
France Gall 1968 Computer Nr. 3 and the incredible German PAL colour encoding system
Clio · Roberto Ferrante - Faces (Prod. by Roberto Ferrante - 2020 Remaster)
Edith Piaf - La Vie En Rose
KlangKuenstler ft. Alice Phoebe Lou - Man On the Moon
Maud Geffray - Moonshine
Gigliola Cinquetti - Non ho l'età (Remastered)
Chill Out Music, - Touch & Go - Straight To Number One
Edith Piaf - Non, Je ne regrette rien
Giuni Russo "Una vipera sarò"
KOMPROMAT - Niemand
Slove - Flash feat. Sarah Rebecca (Official Video)
Ameli Paul -  Encore (Official Music Video)
Amanda Lear - 1977 - Queen Of China-Town
Amanda Lear - 1978 - Follow Me
Blondie Once I Had A Love aka The Disco Song 1975 Version