	Grimes - Venus Fly
	Azealia Banks - 212
	The Swingle Singers - Aria and Variations: "The Harmonious Blacksmith" [Harpsichord Suite No. 5 in E major HWV 430]
	ERA - The Mass
	Giacomo Puccini - Turandot, Act III: Nessun dorma!
	Giacomo Puccini - Turandot, Act III: Nessun dorma!
	Édith Piaf - La Vie en rose
	Wilhelm Strienz - Gute Nacht Mutter!
	The Comet Is Coming - Summon The Fire
	Koop - Strange Love
	Goldfrapp - Strict Machine
	Léonie Pernet - Mon amour tu bois trop
	The Knife - Marble House
	Camille - She Was
	David Holmes presents The Free Association - Sugarman
	Shook - Cloud Symphony
	Jenny Wilson - LET MY SHOES LEAD ME FORWARD
	Ane Brun - Big in Japan
	Alela Diane - The Pirate's Gospel
	Spaccanapoli - Vesuvio
	Chris Isaak - Baby Did A Bad Bad Thing
	Jonathan Richman - I Was Dancing In The Lesbian Bar
	Chrystabell - Swing With Me
	Marlene Dietrich - Sag mir wo die Blumen sind
	Michael Nyman - Time Lapse
	The Dø - Dust It Off
	Enya - Boadicea - 2009 Remaster
	Mari Kvien Brunvoll - Everywhere You Go
	Paul Giovanni - Willow's Song
	Yma Sumac - Gopher
	Ennio Morricone - Here's to you (feat. Joan Baez)
	Wax Tailor - Our Dance
	Pierre Henry - Psyche Rock (Fatboy Slim Malpaso Mix)
	Georges Delerue - Camille
	Bat For Lashes - Daniel
	Red Axes - Sticks & Stones
	Kristin Hersh - Your Ghost
	Erasmus - Ti Ricordi Di Me
    	Julia Holter  -  Sea Calls Me Home   